1111
1100111
10000001
100000001
100000N001
 1100000001
   1110001
     1001
     1111