 1111
1100111
1000001 
 1000S1
1001111111
 100000001
 100000001 
 111111111