1111111
1101011
1000001
100N001
1000001
1001001
1111111