111111
1000001 
 1000N1
1101111111
 100000001
 100000001 
 111111111