NO ./path_to_the_north_texture.xpm
SO ./path_to_the_south_texture.xpm

WE ./path_to_the_west_texture.xpm
EA ./path_to_the_east_texture.xpm

F 220, 100,0
C 225,30,0

        11111111111111111111111111111111111111111111111111111
        1000000000110000000000001
        1011000001110000000000001
        1001000000000000000000001
111111111011000001110000000000001
10000000001100000111011111111111111111111111111111111111111111111
11110111111111011100000010001
11110111111111011101010010001
11000000110101011100000000001
10000000000000001100000000001
100000000000000011010100000011111111111
11000001110101011111011110N011111111111111111111111
11110111 1110101 101111010001
11111111 1111111 11111111111
