NO ./textures/N-wall.xpm
SO ./textures/N-wall.xpm

WE ./textures/W-wall.xpm
EA ./textures/E-wall.xpm


F 200, 150, 100
C 255, 255, 255

        11111111111111111111111111111111111111111111111111111
        1000000000110000000000001
        1011000001110000000000001
        100100000000000000000001
111111111011000001110000000000001
100000000011000001110111111111111111111111111111111111111111111111
11110111111111011100000010001
11110111111111011101010010001
11000000110101011100000000001
10000000000000001100000000001
100000000000000011010100000011111111111
11000001110101011111011110N011111111111111111111111
11110111 1110101 101111010001
11111111 1111111 11111111111

